11111111111
10000000001
10000000111
10000P0E0C1
11111111111