1111111111111
1000000000EC1
1000P00000011
1000000000001
1111111111111