111111111
1000000E1
100C00001
10E0000C1
100000001
1C000P001
111111111