111111111111111111111111111
111111111111111111111111111
11C1111C11111101111111C0E11
110100000100000101C00110111
110001110101110101110100011
110100010000010000010110111
110111010111010111010000011
110001010001000001010111011
111101011101111101010100011
11P000000001C00001000001C11
111111111111111111111111111
111111111111111111111111111
