11111111111111111111111111
100000C00001C00000000100E1
10111111000100011100010111
1010C10000000000C100000001
10101101111111111101111111
100000000000000000001C0001
10000000000010000000100001
11111111110010000000111101
10000000000010011100000001
1P00000000001000C100000001
11111111111111111111111111