111111111
1C10E00C1
111000P01
111111111