111111111
10P0E10C1
100001001
111111111