11111111111111111111
100000000000000000P1
100C0000CCC0CCC00001
100C000C000C000C0001
100C0000C00000C00001
100000000C000C000001
100E000000C0C0000001
10000000000C00000001
11111111111111111111