111111111111111
100P000000100E1
10000C000011111
100000000011111
10C000000000001
111111111111111