111111111111111
1E00000C0000001
1000000000C0001
1000C0000000P01
111111111111111