111111111
10P000EC1
100000111
111111111