11111111111111111111111111
100000C00000000000000100E1
10111111000000011100010111
1010C10000000000C100000001
10101101111111111101111111
100000000000000000001C0001
10000000000000000000100001
11111111110000000000111101
10000000000000000000000001
10000000000000000000000001
11111111111111111111111111