111111111
10000c0E1
100C00001
1000000C1
100c00001
1C000P001
111111111